3 3 3 3 3 3 3 3 3 3 3 3 3 3 3 3 3 3 3 3 3 3 3 3 3
3 3 3 0 0 0 0 0 0 3 3 3 3 3 3 3 3 0 0 0 0 3 3 3 3
3 3 0 1 1 1 1 1 9 0 6 3 3 3 3 0 0 0 1 1 1 1 1 3 3
3 3 0 1 4 4 4 1 0 0 5 0 3 3 3 0 0 0 1 4 4 4 1 0 3
3 0 0 1 4 4 4 1 0 0 0 0 3 3 0 0 1 2 1 4 4 4 1 0 3
3 6 9 1 4 4 4 1 0 0 0 8 8 8 8 0 1 4 4 4 4 4 1 0 3
3 5 0 1 1 2 1 1 0 0 0 0 3 3 0 9 1 4 4 4 4 4 1 0 3
3 0 0 0 0 0 0 0 0 9 0 3 3 3 0 0 1 4 4 4 4 4 1 0 3
3 3 0 0 0 0 0 0 0 0 3 3 3 3 3 0 1 4 4 4 4 4 1 0 3
3 3 3 0 0 7 0 0 0 3 3 3 3 3 3 3 1 1 1 1 1 1 1 3 3
3 3 3 3 3 7 3 3 3 3 3 3 3 3 3 3 3 3 0 0 3 3 3 3 3
3 3 3 3 3 7 3 3 3 3 3 3 3 3 3 3 3 3 3 3 3 3 3 3 3
3 3 3 3 0 7 0 0 0 0 0 3 3 3 3 3 3 3 3 3 3 0 0 3 3
3 3 3 0 0 0 0 0 0 9 0 0 0 3 3 3 3 0 0 0 0 0 0 3 3
3 3 0 0 0 6 0 0 0 0 0 0 0 0 1 0 0 0 0 0 0 0 0 3 3
3 0 0 0 0 5 0 0 0 0 0 0 0 0 1 0 0 0 0 0 0 0 0 0 3
3 0 0 9 0 0 0 0 0 0 6 0 0 0 1 0 0 0 0 0 0 0 0 0 3
3 0 0 0 0 0 0 0 0 0 5 0 0 0 1 0 0 0 0 0 0 0 0 0 3
3 0 0 0 0 0 0 0 0 0 0 0 0 0 2 0 0 0 0 0 0 0 0 0 3
3 3 0 0 0 0 0 0 9 0 0 0 0 0 1 0 0 0 0 0 0 0 0 0 3
3 3 0 0 6 0 0 0 0 0 0 0 0 0 1 0 0 0 0 0 0 0 0 0 3
3 3 0 0 5 0 0 0 0 0 0 0 0 0 1 0 0 0 0 0 0 0 0 0 3
3 3 3 0 0 0 0 0 0 0 3 3 3 3 3 3 3 3 3 0 0 0 0 3 3
3 3 3 3 0 0 0 0 3 3 3 3 3 3 3 3 3 3 3 3 3 3 3 3 3
3 3 3 3 3 3 3 3 3 3 3 3 3 3 3 3 3 3 3 3 3 3 3 3 3