1 1 1 1 1 1 1 1 3 3 3 3 3 3 3 3
1 4 1 4 4 5 6 1 3 0 0 3 3 3 3 3
1 4 1 4 4 4 4 1 0 0 0 0 0 3 3 3
1 4 1 4 4 4 4 1 0 0 0 0 0 0 3 3
1 4 1 1 2 1 1 1 0 0 0 0 0 0 0 3
1 4 4 4 4 4 4 1 0 0 0 0 0 0 0 3
1 4 4 4 4 4 4 1 0 0 0 0 0 0 0 3
1 4 4 4 4 4 4 1 1 2 1 0 0 0 3 3
1 4 4 4 4 4 4 4 4 4 1 0 0 0 3 3
1 4 4 4 4 4 4 4 4 4 1 3 0 0 3 3
1 4 4 4 4 4 4 4 4 4 1 3 3 3 3 3
1 1 1 1 1 1 1 1 1 1 1 3 3 3 3 3